00000000000000000000
00000000000000000000
00000000000000000000
00000002000221120000
00021112000000020000
00000000000000020000
00000000000000000000
00000000000000000000
00000000000000000000
00000000000000000000
00000000000000000000
00000000000000000000
00000000000000000000
00000000000000000000
00000000000000000000
00211200000000020000
00000200002111220000
00000000000000000000
00000000000000000000
00000000000000000000
